..................................................................................................................................................................................................................................................................................................................................
..................................................................................................................................................................................................................................................................................................................................
..................................................................................................................................................................................................................................................................................................................................
..................................................................................................................................................................................................................................................................................................................................
..................................................................................................................................................................................................................................................................................................................................
..................................................................................................................................................................................................................................................................................................................................
..................................................................................................................................................................................................................................................................................................................................
..................................................................................................................................................................................................................................................................................................................................
..................................................................................................................................................................................................................................................................................................................................
..................................................................................................................................................................................................................................................................................................................................
..................................................................................................................................................................................................................................................................................................................................
..................................................................................................................................................................................................................................................................................................................................
..........................................TTTT..............................................PP....................................................................................................................................................................................................................................
.................................................TTTT.....P.......................................................................................................TTT...........T.................................................................................................................................................
..........................................................................................TTTTTT..................................................................TTT..........TTTT...............................................................................................................................................
.............P.........TTT................TTT...........TTT...............................TTTTTT................................TTT...PP..PP..PP..................TTT.........TTTTTT..............................................................................................................................................
.......................TTT..............................TTT............P................P.TTTTTTTT....................P.P.....P.TTT..............................TTTT....PP...TTTTTTTTT........................................................F..................................................................................
..I.................TTTTTT...............P.V............TTTTTT........V.........TTTT......TTTTTTTTTT...................V......P.TTT............................TTTTTT.V..PP...TTTTTTTTT.............V.............................................................................................................................
TTTTTTTTTTTTTTTTTTTTTTTTTTTTTTTTTTTTTTTTTTTTTTTTTTTTTTTTTTTTTTTTTTTTTTTTTTTTTTTTTTTTTTTTTTTTTTTTTTTTTTTTTTTTTTTTTTTTTTTTTTTTTTTTTTTTTTTTTTTTTTTTTTTTTTTTTTTTTTTTTTTTTTTTTTTTTTTTTTTTTTTTTTTTTTTTTTTTTTTTTTTTTTTTTTTTTTTTTTTTTTTTTTTTTTTTTTEEEEEEEEEEEEEEEEEEEEEEEEEEEEEEEEEEEEEEEEEEEEEEEEEEEEEEEEEEEEEEEEEEEEEEEEEEEEEEEEEEEEEEEE
TTTTTTTTTTTTTTTTTTTTTTTTTTTTTTTTTTTTTTTTTTTTTTTTTTTTTTTTTTTTTTTTTTTTTTTTTTTTTTTTTTTTTTTTTTTTTTTTTTTTTTTTTTTTTTTTTTTTTTTTTTTTTTTTTTTTTTTTTTTTTTTTTTTTTTTTTTTTTTTTTTTTTTTTTTTTTTTTTTTTTTTTTTTTTTTTTTTTTTTTTTTTTTTTTTTTTTTTTTTTTTTTTTTTTTTTTTEEEEEEEEEEEEEEEEEEEEEEEEEEEEEEEEEEEEEEEEEEEEEEEEEEEEEEEEEEEEEEEEEEEEEEEEEEEEEEEEEEEEEEEE