....................................................................................................................................................................................................................................................................................................................
....................................................................................................................................................................................................................................................................................................................
....................................................................................................................................................................................................................................................................................................................
....................................................................................................................................................................................................................................................................................................................
....................................................................................................................................................................................................................................................................................................................
....................................................................................................................................................................................................................................................................................................................
....................................................................................................................................................................................................................................................................................................................
....................................................................................................................................................................................................................................................................................................................
.....................................................................................................................EEE....E....EEEEEEEEEEEE.........EEE...........................................................................................................................................................
......................................................................................................................................EE....................EEE.....................................................................................................................................................
....................................................................................................EE....P....EEE....................EE............................................................................................................................................................................
......................................................................................................................................EE............................................................................................................................................................................
..........................................................................EEE.....................EE.......EEE...............PPP....................................................................................................................................................................................
....................................................................EEE..................................EEE.........................................................................PP.............................................................................................................................
....................................................................EEE.................EEEEEE...........EEEEEEEEE.......EEEEEEE....................................................................................................................................................................................
.......................EEEEEE.....................................PEEEEEEE...............................EEE......................PPP.E........................................EEEEEEEEEEEE.................E..............E........................................................................................
.................EEE.....P..PP..EEEEEE............................P.EEE.........................................................P.....EE....................................................................E..............E...................F....................................................................
..I..............EEE......V.PP..EEE.............V.....V........V....EEE..V...........V........V...............PPPP...............P.VEEEE..................V........PP..PP......V............................E...V.......V..E........................................................................................
EEEEEEEEEEEEEEEEEEEEEEEEEEEEEEEEEEEEEEEEEEEEEEEEEEEEEEEEEEEEEEEEEEEEEEEEEEEEEEEEEEEEEEEEEEEEEEEEEEEEEEEEEEEEEEEEEEEEEEEEEEEEEEEEEEEEEEEEEEEEEEEEEEEEEEEEEEEEEEEEEEEEEEEEEEEEEEEEEEEEEEEEEEEEEEEEEEEEEEEEEEEEEEEEEEEEEEEEEEEEEEEEEEEEEEEEEEEEEEEEEEEEEEEEEEEEEEEEEEEEEEEEEEEEEEEEEEEEEEEEEEEEEEEEEEEEEEEEEEEEEEEEEEEE
EEEEEEEEEEEEEEEEEEEEEEEEEEEEEEEEEEEEEEEEEEEEEEEEEEEEEEEEEEEEEEEEEEEEEEEEEEEEEEEEEEEEEEEEEEEEEEEEEEEEEEEEEEEEEEEEEEEEEEEEEEEEEEEEEEEEEEEEEEEEEEEEEEEEEEEEEEEEEEEEEEEEEEEEEEEEEEEEEEEEEEEEEEEEEEEEEEEEEEEEEEEEEEEEEEEEEEEEEEEEEEEEEEEEEEEEEEEEEEEEEEEEEEEEEEEEEEEEEEEEEEEEEEEEEEEEEEEEEEEEEEEEEEEEEEEEEEEEEEEEEEEEEEEE