....................................................................................................................................................................................................................................................................................................................
....................................................................................................................................................................................................................................................................................................................
......................................................................................................................................WW............................................................................................................................................................................
....................................................................................................................................................................................................................................................................................................................
.....................................................................................................................................LSSR...........................................................................................................................................................................
...............................................................................................................................V................V...................................................................................................................................................................
...........................................................................................................................LSSSSR...LSSSSR...LSSSSR..........W......................................................................................................................................................
.............................................W...............................................................................................................W......................................................................................................................................................
...................................................W............................................................W....LSR.........LSSSSTTSSSSR.........LSR...........................................................................................................................................................
............................................LSR..........W............................................................................MM....................LSR.....................................................................................................................................................
.................................W....EEE.........LSR..........W.....W..............................LR....W....LSR....................MM............................................................................................................................................................................
.................................W..V.MMM...............LSR..........W........................WW......................................MM..............LSR...........................................................................................................................................................
................................LSSSSSMMM..........V..........LSR.........LSR............WW.W.....LR.......ESR...............WWW....................................................................................................................................................................................
..................................................LSR...............EEE....................V.............MMM...........................................W....LSR......................WW.............................................................................................................................
....................................................................MMM.................LSSSSR...........MMMSSSSSR.......LSSSSSR....................................................................................................................................................................................
.......................LSSSSR...............LSR...WW..............W.MMMSSR...............................MMM......................WWW.MM..............LSR.......................LSSSSSSSSSSR........................................................................................................................
.................EEE.....W..W...EEESSR............................W.MMM...W............WW.WW....................................W.....MM.......................................................................................................F....................................................................
..I..............MMM......V.WW..MMM.............V.....V........V....MMM..VW..........V........V...............WWWWW...............W.VMMMM..................V........WW..WW......V................................V...WWW.V..........................................................................................
EEEEEEEEEEEEEEEEEMMMEEEEEEEEEEEEMMMEEEEEEEEEEEEEEEEEEEEEEEEEEEEEEEEEMMMEEEEEEEEEEEEEEEEEEEEEEEEEEEEEEEEEEEEEEEEEEEEEEEEEEEEEEEEEEEEEEMMMMEEEEEEEEEEEEEEEEEEEEEEEEEEEEEEEEEEEEEEEEEEEEEEEEEEEEEEEEEEEEEEEEEEEEEEEEEEEEEEEEEEEEEEEEEEEEEEEEEEEEEEEEEEEEEEEEEEEEEEEEEEEEEEEEEEEEEEEEEEEEEEEEEEEEEEEEEEEEEEEEEEEEEEEEEEE
MMMMMMMMMMMMMMMMMMMMMMMMMMMMMMMMMMMMMMMMMMMMMMMMMMMMMMMMMMMMMMMMMMMMMMMMMMMMMMMMMMMMMMMMMMMMMMMMMMMMMMMMMMMMMMMMMMMMMMMMMMMMMMMMMMMMMMMMMMMMMMMMMMMMMMMMMMMMMMMMMMMMMMMMMMMMMMMMMMMMMMMMMMMMMMMMMMMMMMMMMMMMMMMMMMMMMMMMMMMMMMMMMMMMMMMMMMMMMMMMMMMMMMMMMMMMMMMMMMMMMMMMMMMMMMMMMMMMMMMMMMMMMMMMMMMMMMMMMMMMMMMMMMMM