....................................................................................................................................................................................................................................................................................................................
....................................................................................................................................................................................................................................................................................................................
....................................................................................................................................................................................................................................................................................................................
....................................................................................................................................................................................................................................................................................................................
....................................................................................................................................................................................................................................................................................................................
....................................................................................................................................................................................................................................................................................................................
....................................................................................................................................................................................................................................................................................................................
....................................................................................................................................................................................................................................................................................................................
.....................................................................................................................EEE....E....EEEEEEEEEEEE.........EEE...........................................................................................................................................................
......................................................................................................................................EE....................EEE.....................................................................................................................................................
....................................................................................................EE....P....EEE....................EE............................................................................................................................................................................
..............................................................................................WW......................................EE............................................................................................................................................................................
..........................................................................EEE............WW.W.....EE.......EEE...............PPP....................................................................................................................................................................................
....................................................................EEE....................V.............EEE.........................................................................PP.............................................................................................................................
....................................................................EEE.................EEEEEE...........EEEEEEEEE.......EEEEEEE....................................................................................................................................................................................
.......................EEEEEE.....................................PEEEEEEE...............................EEE......................PPP.E........................................EEEEEEEEEEEE.........................................................................................................................
.................EEE.....P..PP..EEEEEE............................P.EEE................WW.WW....................................P.....EE.......................................................................................................F....................................................................
..I..............EEE......V.PP..EEE.............V.....V........V....EEE..V...........V........V...............PPPP...............P.VEEEE..................V........PP..PP......V................................V...WWW.V...........................................................................................
EEEEEEEEEEEEEEEEEEEEEEEEEEEEEEEEEEEEEEEEEEEEEEEEEEEEEEEEEEEEEEEEEEEEEEEEEEEEEEEEEEEEEEEEEEEEEEEEEEEEEEEEEEEEEEEEEEEEEEEEEEEEEEEEEEEEEEEEEEEEEEEEEEEEEEEEEEEEEEEEEEEEEEEEEEEEEEEEEEEEEEEEEEEEEEEEEEEEEEEEEEEEEEEEEEEEEEEEEEEEEEEEEEEEEEEEEEEEEEEEEEEEEEEEEEEEEEEEEEEEEEEEEEEEEEEEEEEEEEEEEEEEEEEEEEEEEEEEEEEEEEEEEEEE
EEEEEEEEEEEEEEEEEEEEEEEEEEEEEEEEEEEEEEEEEEEEEEEEEEEEEEEEEEEEEEEEEEEEEEEEEEEEEEEEEEEEEEEEEEEEEEEEEEEEEEEEEEEEEEEEEEEEEEEEEEEEEEEEEEEEEEEEEEEEEEEEEEEEEEEEEEEEEEEEEEEEEEEEEEEEEEEEEEEEEEEEEEEEEEEEEEEEEEEEEEEEEEEEEEEEEEEEEEEEEEEEEEEEEEEEEEEEEEEEEEEEEEEEEEEEEEEEEEEEEEEEEEEEEEEEEEEEEEEEEEEEEEEEEEEEEEEEEEEEEEEEEEEE